2:0:1,2:0:1,2:0:1,2:0:1,2:0:1,2:0:1,0:0:1,0:0:1,2:0:1,2:0:1,4:0:1,4:0:1,4:0:1,4:0:1,4:0:1
2:0:1,0:0:1,0:0:1,0:0:1,2:0:1,2:0:1,0:0:1,0:0:1,2:0:1,2:0:1,4:0:1,4:0:1,4:0:1,4:0:1,4:0:1
2:0:1,0:0:1,3:0:1,0:0:1,3:0:1,2:0:1,0:0:1,0:0:1,2:0:1,2:0:1,4:9:1,4:0:1,4:0:1,4:0:1,4:0:1
2:0:1,3:0:1,3:0:1,3:0:1,3:0:1,2:0:1,2:0:1,2:0:1,2:0:1,2:0:1,4:0:1,4:0:1,4:0:1,4:0:1,4:0:1
2:0:1,2:0:1,3:0:1,3:0:1,2:0:1,2:0:1,1:0:1,2:0:1,2:0:1,2:0:1,4:0:1,4:0:1,4:0:1,4:0:1,4:0:1
2:0:1,4:0:1,4:0:1,4:0:1,4:0:1,2:0:1,1:0:1,0:0:1,0:0:1,2:0:1,4:0:1,4:0:1,4:0:1,0:0:1,0:0:1
2:0:1,4:0:1,4:0:1,4:0:1,4:0:1,2:0:1,1:0:1,1:3:1,2:0:1,2:0:1,4:0:1,4:0:1,4:0:1,4:0:1,4:0:1
2:0:1,4:0:1,4:0:1,4:0:1,4:0:1,2:0:1,2:0:1,1:0:1,2:0:1,0:0:1,2:0:1,2:0:1,2:0:1,2:0:1,2:0:1
2:0:1,1:0:1,1:0:1,1:0:1,1:0:1,1:0:1,1:0:1,1:0:1,2:0:1,0:0:1,1:0:1,1:0:1,2:0:1,2:0:1,2:0:1
2:0:1,1:0:1,1:0:1,1:0:1,1:0:1,1:0:1,1:0:1,1:0:1,2:0:1,0:0:1,1:7:1,1:0:1,2:0:1,2:0:1,2:0:1
2:0:1,2:0:1,2:0:1,2:0:1,2:0:1,2:0:1,2:0:1,2:0:1,2:0:1,0:0:1,0:0:1,0:0:1,2:0:1,2:0:1,2:0:1
2:0:1,2:0:1,2:0:1,1:0:1,2:0:1,2:0:1,2:0:1,2:0:1,2:0:1,0:0:1,0:0:1,0:0:1,1:0:1,1:4:1,1:0:1
1:0:1,1:0:1,1:0:1,1:0:1,1:0:1,1:0:1,1:0:1,1:0:1,2:0:1,2:0:1,2:0:1,1:0:1,0:0:1,2:0:1,2:0:1
1:0:1,1:0:1,1:0:1,1:0:1,1:0:1,1:0:1,1:0:1,1:0:1,2:0:1,2:0:1,2:0:1,1:0:1,1:0:1,1:0:1,1:0:1
1:0:1,1:0:1,1:0:1,1:0:1,1:0:1,1:0:1,2:0:1,2:0:1,2:0:1,2:0:1,2:0:1,1:0:1,1:0:1,1:8:1,1:0:1

