4:0:1,4:0:1,4:0:1,1:0:1,1:0:1,1:0:1,1:0:1,1:0:1,1:0:1,1:0:1,1:0:1,1:0:1,1:0:1,4:0:1,4:2:1
4:0:1,4:0:1,4:0:1,4:0:1,4:0:1,4:0:1,1:0:1,1:0:1,1:0:1,1:0:1,4:0:1,3:0:1,4:0:1,4:0:1,4:0:1
4:0:1,4:0:1,4:0:1,2:0:1,2:0:1,4:0:1,1:0:1,4:0:1,1:0:1,1:0:1,3:0:1,3:0:1,4:0:1,1:0:1,1:0:1
4:0:1,4:0:1,2:0:1,2:0:1,2:0:1,2:0:1,1:0:1,4:0:1,1:0:1,1:0:1,3:0:1,3:0:1,4:0:1,1:0:1,1:0:1
4:0:1,4:0:1,2:0:1,2:0:1,2:0:1,2:0:1,1:0:1,4:0:1,4:0:1,1:0:1,1:0:1,3:0:1,1:0:1,1:0:1,1:0:1
4:0:1,4:0:1,4:0:1,2:0:1,2:0:1,1:0:1,1:0:1,1:0:1,1:0:1,1:0:1,1:0:1,3:0:1,3:0:1,3:0:1,3:0:1
4:0:1,4:0:1,4:0:1,0:0:1,0:0:1,0:0:1,1:0:1,1:0:1,1:0:1,1:0:1,1:0:1,3:0:1,3:0:1,3:0:1,3:0:1
4:0:1,4:0:1,4:0:1,1:0:1,0:0:1,4:0:1,4:0:1,1:0:1,1:0:1,3:0:1,3:0:1,3:0:1,3:0:1,2:0:1,2:0:1
4:0:1,4:0:1,4:0:1,1:0:1,1:0:1,4:0:1,4:0:1,0:0:1,1:0:1,3:0:1,3:0:1,3:0:1,2:0:1,2:0:1,2:0:1
4:0:1,4:0:1,1:0:1,1:0:1,1:0:1,1:0:1,0:0:1,0:0:1,0:0:1,3:0:1,3:0:1,2:5:1,2:0:1,2:0:1,2:0:1
4:0:1,4:0:1,1:0:1,1:0:1,1:0:1,1:0:1,1:0:1,1:0:1,3:0:1,3:0:1,3:0:1,2:0:1,2:0:1,2:0:1,2:0:1
4:0:1,4:0:1,1:0:1,1:0:1,1:0:1,1:0:1,1:0:1,1:0:1,3:0:1,3:0:1,2:0:1,2:0:1,2:0:1,2:0:1,2:0:1
4:0:1,4:0:1,1:0:1,4:0:1,4:0:1,1:0:1,1:0:1,3:0:1,3:0:1,3:0:1,2:0:1,2:0:1,2:0:1,2:0:1,2:0:1
4:0:1,4:0:1,4:0:1,4:0:1,4:0:1,4:0:1,1:0:1,3:0:1,3:0:1,3:0:1,2:0:1,2:0:1,2:0:1,2:0:1,2:0:1
4:0:1,4:0:1,4:0:1,4:0:1,4:0:1,4:0:1,1:0:1,3:0:1,3:0:1,3:0:1,2:0:1,2:0:1,2:0:1,2:0:1,2:0:1


